11111111
1P000001
100000C1
11111111