11111111
1P0001E1
1000C111
11111111