11111111
1P0000P1
100000C1
11111111