11111111
11111111
1P00E1C1
11111111