11111111
1P000EE1
100000C1
11111111