11111111
1P0000R1
100E00C1
11111111