111111111111111111111111111111111111111111111111
10000000000C100000000000000000000000000000000001
10000111110010CCCCCCCCCCCCCCCCCCCCCCCCCCCCCCCC01
10110111110010CCCCCCCCCCCCCCCCCCCCCCCCCCCCCCCC01
1000011111001000CCCCCCCCCCCCCCCCCCCCCCCCCCCCCC01
1011011111001000CCCCCCCCCCCCCCCCCCCCCCCCCCCCCC01
10000111110010CCCCCCCCCCCCCCCCCCCCCCCCCCCCCCCC01
10000111110010CCCCCCCCCCCCCCCCCCCCCCCCCCCCCCCC01
10110111110000CCCCCCCCCCCCCCCCCCCCCCCCCCCCCCCC01
1000011111CC000CCCCCCCCCCCCCCCCCCCCCCCCCCCCCCCC1
1011011111CC10CCCCCCCCCCCCCCCCCCCCCCCCCCCCCCC001
1P0001ECCCCC100CCCCCCCCCCCCCCCCCCCCCCCCCCCCCCC01
111111111C1110CCCCCCCCCCCCCCCCCCCCCCCCCCCCCCC001
1CCCCCCCCCCC100CCCCCCCCCCCCCCCCCCCCCCCCCCCCC0001
111111111111111111111111111111111111111111111111