11111111111111111111111111
1P0C00C000CCCCCC000C000001
100C00C00000000C000C000001
100CCCCC00CCCCCC000C000001
100000C000C000000000000001
100000C000CCCCCC000C0000E1
11111111111111111111111111